,Unnamed: 0.4,Unnamed: 0.3,Unnamed: 0.2,Unnamed: 0.1,Unnamed: 0,FILE_NAME,STATES,INPUTS,LSTAR_MQ_SYM,LSTAR_MQ_RST,LSTAR_EQ_SYM,LSTAR_EQ_RST,LSTAR_TOTAL_SYM,LSTAR_TOTAL_RST,LSTAR_EQs,LSTAR_MQs,CLSTAR_MQ_SYM,CLSTAR_MQ_RST,CLSTAR_EQ_SYM,CLSTAR_EQ_RST,CLSTAR_TOTAL_SYM,CLSTAR_TOTAL_RST,CLSTAR_EQs,CLSTAR_COMPONENTS,CLSTAR_ROUNDS,CLSTAR_MQs,CACHE
0,0.0,0.0,0.0,0.0,0.0,1,19200,17,10168467,517360,74699,501,10243166,517861,2,548204,1050587,13366,2195770,14619,3246357,27985,143,9,8,26740,True
1,1.0,1.0,1.0,1.0,1.0,2,19200,17,15045200,580828,75923,502,15121123,581330,3,615456,947881,11983,2189874,14614,3137755,26597,143,9,8,25968,True
2,2.0,2.0,2.0,2.0,2.0,3,19200,17,15161048,575719,74905,503,15235953,576222,3,610373,1351583,16732,2190255,14630,3541838,31362,144,9,8,32352,True
3,3.0,3.0,3.0,3.0,3.0,4,9216,17,7817484,220315,75765,501,7893249,220816,2,233449,4606554,64971,4592869,30617,9199423,95588,223,9,14,88326,True
4,4.0,4.0,4.0,4.0,4.0,5,9216,17,9979710,221422,75604,501,10055314,221923,2,234622,5749142,80267,3773228,25135,9522370,105402,219,9,14,106607,True
5,5.0,5.0,5.0,5.0,5.0,6,9216,17,9434923,224005,75904,501,9510827,224506,2,237359,5042260,64127,4365606,29133,9407866,93260,205,9,13,87531,True
6,6.0,6.0,6.0,6.0,6.0,7,12960,17,22982290,426875,74720,503,23057010,427378,3,453499,910503,11738,1668831,11098,2579334,22836,120,9,7,19566,True
7,7.0,7.0,7.0,7.0,7.0,8,12960,17,24469545,387245,74947,501,24544492,387746,2,411424,928962,12488,1667588,11101,2596550,23589,122,9,7,20575,True
8,8.0,8.0,8.0,8.0,8.0,9,12960,17,26309363,437334,75406,503,26384769,437837,3,464549,1067375,13365,1675357,11117,2742732,24482,121,9,7,22323,True
9,9.0,9.0,9.0,9.0,9.0,10,28800,17,39699780,1204682,75744,505,39775524,1205187,4,1279173,3444177,42915,5351492,35675,8795669,78590,254,9,15,78879,True
10,10.0,10.0,10.0,10.0,10.0,11,28800,17,35171624,1194145,77235,511,35248859,1194656,4,1269891,3420031,40274,5051488,33661,8471519,73935,262,9,15,76905,True
11,11.0,11.0,11.0,11.0,11.0,12,28800,17,31035125,1138027,75983,502,31111108,1138529,3,1211547,2813902,34591,5273857,35161,8087759,69752,259,9,15,67072,True
12,12.0,12.0,12.0,12.0,12.0,13,13824,17,66627784,2795796,74808,501,66702592,2796297,2,2963124,7612895,95155,6394052,42666,14006947,137821,272,9,16,139245,True
13,13.0,13.0,13.0,13.0,13.0,14,13824,17,61982331,2792187,75779,501,62058110,2792688,2,2959299,7360191,93263,6999454,46666,14359645,139929,275,9,16,136231,True
14,14.0,14.0,14.0,14.0,14.0,15,13824,17,72642546,2794994,75237,501,72717783,2795495,2,2962274,6967114,92602,5953825,39664,12920939,132266,275,9,16,133584,True
15,15.0,15.0,15.0,15.0,15.0,16,24000,17,79030677,1473816,76095,501,79106772,1474317,2,1576949,7981598,100945,4457011,29664,12438609,130609,236,9,14,140367,True
16,16.0,16.0,16.0,16.0,16.0,17,24000,17,45275662,1533667,75039,503,45350701,1534170,3,1638149,7805500,98280,4451441,29659,12256941,127939,227,9,14,134654,True
17,17.0,17.0,17.0,17.0,17.0,18,24000,17,42590717,1421295,75986,501,42666703,1421796,2,1518468,8657726,104207,4530395,30140,13188121,134347,232,9,14,142402,True
18,18.0,18.0,18.0,18.0,18.0,19,15360,17,22643690,572727,74801,502,22718491,573229,3,608624,5545942,71476,5862889,39117,11408831,110593,225,9,15,98534,True
19,19.0,19.0,19.0,19.0,19.0,20,15360,17,28191954,592652,75218,502,28267172,593154,3,629449,7560368,93896,4374738,29128,11935106,123024,211,9,14,124902,True
20,20.0,20.0,20.0,20.0,20.0,21,15360,17,16783979,508508,75060,501,16859039,509009,2,539807,5040808,59646,4814038,32115,9854846,91761,196,9,13,80026,True
21,21.0,21.0,21.0,21.0,21.0,22,8640,17,54005489,1749730,73831,501,54079320,1750231,2,1860674,7969878,102111,6548496,43665,14518374,145776,269,9,16,144445,True
22,22.0,22.0,22.0,22.0,22.0,23,8640,17,37433532,1742259,75138,501,37508670,1742760,2,1848349,8087460,95612,6185917,41173,14273377,136785,263,9,15,137026,True
23,23.0,23.0,23.0,23.0,23.0,24,8640,17,63213889,1753202,75245,501,63289134,1753703,2,1865774,7435401,95864,6937871,46191,14373272,142055,267,9,16,135915,True
24,24.0,24.0,24.0,24.0,24.0,25,8640,17,15746800,308369,75322,502,15822122,308871,3,327239,877733,10647,1676980,11106,2554713,21753,122,9,7,20516,True
25,25.0,25.0,25.0,25.0,25.0,26,8640,17,13015004,306379,74839,503,13089843,306882,3,324791,877748,11196,1670385,11115,2548133,22311,121,9,7,20151,True
26,26.0,26.0,26.0,26.0,26.0,27,8640,17,13613771,255654,75394,501,13689165,256155,2,271343,692348,9016,1672374,11104,2364722,20120,118,9,7,17104,True
27,27.0,27.0,27.0,27.0,27.0,28,17280,17,8659409,167481,73790,501,8733199,167982,2,177536,5825333,74111,2876622,19145,8701955,93256,197,9,13,95644,True
28,28.0,28.0,28.0,28.0,28.0,29,17280,17,14938313,255305,75323,505,15013636,255810,3,270935,7402845,82505,3256438,21656,10659283,104161,204,9,13,106536,True
29,29.0,29.0,29.0,29.0,29.0,30,17280,17,16506827,219894,76419,508,16583246,220402,3,233058,6826250,84882,3101539,20647,9927789,105529,209,9,13,108879,True
30,30.0,30.0,30.0,30.0,30.0,31,3600,15,3765978,114066,76096,501,3842074,114567,2,121925,836277,9851,1214739,8105,2051016,17956,105,8,6,21169,True
31,31.0,31.0,31.0,31.0,31.0,32,3600,15,5053922,119340,74888,501,5128810,119841,2,127595,990860,11538,1215809,8092,2206669,19630,105,8,6,22864,True
32,32.0,32.0,32.0,32.0,32.0,33,3600,15,7286570,154883,74762,502,7361332,155385,3,165710,1002015,12270,1216142,8103,2218157,20373,105,8,6,23898,True
33,33.0,33.0,33.0,33.0,33.0,34,8000,15,15825055,311598,75225,501,15900280,312099,2,334149,1589539,20580,2489752,16612,4079291,37192,173,8,11,43306,True
34,34.0,34.0,34.0,34.0,34.0,35,8000,15,22948669,310038,75641,501,23024310,310539,2,332303,2321034,28762,3091064,20628,5412098,49390,188,8,12,52298,True
35,35.0,35.0,35.0,35.0,35.0,36,8000,15,9231801,294536,74404,501,9306205,295037,2,315743,2111490,25705,2951572,19617,5063062,45322,184,8,12,50789,True
36,36.0,36.0,36.0,36.0,36.0,37,24300,15,13822384,391659,74054,504,13896438,392163,3,420024,1290360,14627,1218293,8103,2508653,22730,101,8,6,26092,True
37,37.0,37.0,37.0,37.0,37.0,38,24300,15,18906721,416179,74519,503,18981240,416682,3,445899,975890,12923,1214824,8092,2190714,21015,102,8,6,24304,True
38,38.0,38.0,38.0,38.0,38.0,39,24300,15,16696593,410642,75139,503,16771732,411145,3,439555,1029175,13436,1216305,8097,2245480,21533,101,8,6,24634,True
39,39.0,39.0,39.0,39.0,39.0,40,12000,15,15407589,709653,77028,507,15484617,710160,3,757987,1090458,13034,1219758,8117,2310216,21151,101,8,6,23995,True
40,40.0,40.0,40.0,40.0,40.0,41,12000,15,20031606,735816,75729,504,20107335,736320,3,785932,936981,11889,1212371,8098,2149352,19987,104,8,6,23725,True
41,41.0,41.0,41.0,41.0,41.0,42,12000,15,15635109,757176,75691,503,15710800,757679,3,810743,1187802,14312,1215388,8102,2403190,22414,99,8,6,25088,True
42,42.0,42.0,42.0,42.0,42.0,43,14400,15,22367892,458302,75207,501,22443099,458803,2,491274,1226019,14586,1218105,8089,2444124,22675,106,8,6,29580,True
43,43.0,43.0,43.0,43.0,43.0,44,14400,15,15682929,463763,75602,501,15758531,464264,2,498024,946514,12724,1220947,8102,2167461,20826,105,8,6,25549,True
44,44.0,44.0,44.0,44.0,44.0,45,14400,15,14791598,453728,75530,501,14867128,454229,2,486399,1011078,13254,1217788,8108,2228866,21362,106,8,6,26747,True
45,45.0,45.0,45.0,45.0,45.0,46,7680,15,25176963,750522,75931,501,25252894,751023,2,801743,6962424,85134,4447446,29630,11409870,114764,209,8,13,122164,True
46,46.0,46.0,46.0,46.0,46.0,47,7680,15,27488777,720996,75685,501,27564462,721497,2,772132,5557099,65712,3919469,26114,9476568,91826,197,8,12,96102,True
47,47.0,47.0,47.0,47.0,47.0,48,7680,15,22597900,720390,75149,501,22673049,720891,2,771442,6855681,81855,4752938,31636,11608619,113491,204,8,13,116593,True
48,48.0,48.0,48.0,48.0,48.0,49,21600,15,15830610,528910,74821,503,15905431,529413,3,565641,7047536,85976,3923382,26137,10970918,112113,211,8,14,117354,True
49,49.0,49.0,49.0,49.0,49.0,50,21600,15,14672040,494440,74026,502,14746066,494942,3,527960,5146329,63673,5203642,34634,10349971,98307,213,8,14,95054,True
50,50.0,50.0,50.0,50.0,50.0,51,21600,15,14136806,451536,75211,501,14212017,452037,2,482600,4288141,56353,5042142,33620,9330283,89973,208,8,14,84873,True
51,51.0,51.0,51.0,51.0,51.0,52,2160,15,2529591,53952,75461,501,2605052,54453,2,57588,1940267,23058,3395152,22619,5335419,45677,173,8,12,38227,True
52,52.0,52.0,52.0,52.0,52.0,53,2160,15,2228280,53151,74168,501,2302448,53652,2,56733,1647771,21204,3478037,23124,5125808,44328,170,8,12,35196,True
53,53.0,53.0,53.0,53.0,53.0,54,2160,15,3483726,59559,75147,501,3558873,60060,2,63573,1136578,13953,2789985,18601,3926563,32554,157,8,12,23489,True
54,54.0,54.0,54.0,54.0,54.0,55,14400,15,110601351,1787558,74729,502,110676080,1788060,3,1918045,6894111,81268,5120303,34135,12014414,115403,228,8,14,126946,True
55,55.0,55.0,55.0,55.0,55.0,56,14400,15,105044938,1888206,74853,502,105119791,1888708,3,2023406,5928439,76675,4748791,31641,10677230,108316,228,8,14,121783,True
56,56.0,56.0,56.0,56.0,56.0,57,14400,15,111146557,1864220,75584,502,111222141,1864722,3,1998701,7537169,87145,4307456,28637,11844625,115782,214,8,13,131554,True
57,57.0,57.0,57.0,57.0,57.0,58,30000,15,119072472,6200475,76613,508,119149085,6200983,4,6650743,2122863,25236,2187308,14618,4310171,39854,136,8,8,48715,True
58,58.0,58.0,58.0,58.0,58.0,59,30000,15,140477547,6218486,75331,507,140552878,6218993,5,6685978,1991975,25181,2203872,14657,4195847,39838,133,8,8,45415,True
59,59.0,59.0,59.0,59.0,59.0,60,30000,15,169000045,6177376,76416,514,169076461,6177890,4,6645958,1914632,26096,2200029,14636,4114661,40732,135,8,8,47162,True
60,60.0,60.0,60.0,60.0,,61,1536,13,2690510,40162,74501,501,2765011,40663,2,43307,4113761,49228,1738735,11589,5852496,60817,126,7,10,65328,True
61,61.0,61.0,61.0,61.0,,62,1536,13,2172236,38426,75449,502,2247685,38928,2,41435,4395579,51335,1592520,10592,5988099,61927,126,7,10,67826,True
62,62.0,62.0,62.0,62.0,,63,1536,13,2686760,42741,74398,502,2761158,43243,2,46115,2594957,34734,2338459,15591,4933416,50325,128,7,10,48918,True
63,63.0,63.0,63.0,63.0,,64,6912,13,3421331,95055,74557,503,3495888,95558,3,102770,3556488,43486,2046470,13625,5602958,57111,133,7,10,62324,True
64,64.0,64.0,64.0,64.0,,65,6912,13,6209427,111245,79623,512,6289050,111757,3,120307,3243165,40806,1892340,12609,5135505,53415,119,7,9,55868,True
65,65.0,65.0,65.0,65.0,,66,6912,13,1649801,67755,74509,501,1724310,68256,2,73130,3141975,41556,2114002,14097,5255977,55653,136,7,10,59933,True
66,66.0,66.0,66.0,66.0,,67,720,13,1957008,39294,75665,501,2032673,39795,2,42371,621253,7523,838393,5579,1459646,13102,69,7,5,12474,True
67,67.0,67.0,67.0,67.0,,68,720,13,2208215,41681,75214,501,2283429,42182,2,44945,637405,7699,839096,5578,1476501,13277,69,7,5,12822,True
68,68.0,68.0,68.0,68.0,,69,720,13,2617615,44068,75390,501,2693005,44569,2,47519,436391,5650,836988,5586,1273379,11236,67,7,5,9525,True
69,69.0,69.0,69.0,69.0,,70,5120,13,22992814,433561,75734,502,23068548,434063,3,467917,4529017,57436,3319719,22121,7848736,79557,153,7,11,84121,True
70,70.0,70.0,70.0,70.0,,71,5120,13,21715147,442391,74595,501,21789742,442892,2,477525,5661828,65826,3390012,22627,9051840,88453,167,7,12,94077,True
71,71.0,71.0,71.0,71.0,,72,5120,13,23649697,425060,75763,502,23725460,425562,3,458660,5505771,64450,3850154,25653,9355925,90103,171,7,12,94950,True
72,72.0,72.0,72.0,72.0,,73,7500,13,31876936,930959,75241,503,31952177,931462,3,1010903,4770760,58535,2714671,18116,7485431,76651,141,7,10,85667,True
73,73.0,73.0,73.0,73.0,,74,7500,13,25893972,923452,74963,505,25968935,923957,3,999047,6067521,75264,2717061,18106,8784582,93370,163,7,12,104197,True
74,74.0,74.0,74.0,74.0,,75,7500,13,35738706,1005342,76003,504,35814709,1005846,4,1092349,5199496,65269,3772632,25133,8972128,90402,166,7,12,99356,True
75,75.0,75.0,75.0,75.0,,76,4000,13,18454689,456814,75840,502,18530529,457316,3,493331,5153174,62732,3027075,20105,8180249,82837,165,7,12,90024,True
76,76.0,76.0,76.0,76.0,,77,4000,13,22030636,440318,73967,501,22104603,440819,2,475639,4601718,56679,3701523,24616,8303241,81295,161,7,12,84178,True
77,77.0,77.0,77.0,77.0,,78,4000,13,18040318,417069,75088,501,18115406,417570,2,451562,5329282,61698,3238381,21605,8567663,83303,153,7,12,85651,True
78,78.0,78.0,78.0,78.0,,79,5400,13,3409554,48309,75736,501,3485290,48810,2,52135,3334279,39433,2040974,13593,5375253,53026,126,7,10,54727,True
79,79.0,79.0,79.0,79.0,,80,5400,13,4678121,74203,75241,504,4753362,74707,3,80046,2727023,35481,2340104,15592,5067127,51073,128,7,10,51090,True
80,80.0,80.0,80.0,80.0,,81,5400,13,3730166,52671,75275,501,3805441,53172,2,56828,3348897,39828,2117440,14091,5466337,53919,127,7,10,56517,True
81,81.0,81.0,81.0,81.0,,82,6750,13,7069477,80694,77595,520,7147072,81214,3,87456,236700,3201,313715,2080,550415,5281,42,7,3,5503,True
82,82.0,82.0,82.0,82.0,,83,6750,13,3810190,60837,75093,504,3885283,61341,3,65799,224079,2985,313711,2074,537790,5059,42,7,3,5083,True
83,83.0,83.0,83.0,83.0,,84,6750,13,4857210,66631,75944,508,4933154,67139,3,72142,274373,3403,311988,2071,586361,5474,42,7,3,5730,True
84,84.0,84.0,84.0,84.0,,85,2160,13,9050384,158398,75494,501,9125878,158899,2,170918,4978566,58565,2709621,18117,7688187,76682,149,7,11,82943,True
85,85.0,85.0,85.0,85.0,,86,2160,13,9745343,167148,75294,501,9820637,167649,2,180473,4233798,54025,2951225,19622,7185023,73647,157,7,11,78893,True
86,86.0,86.0,86.0,86.0,,87,2160,13,6625279,157146,75459,501,6700738,157647,2,169826,4219418,52895,2866046,19115,7085464,72010,148,7,11,75398,True
87,87.0,87.0,87.0,87.0,,88,4320,13,12909627,207262,75322,506,12984949,207768,3,224245,4544759,55543,2497297,16616,7042056,72159,144,7,11,76634,True
88,88.0,88.0,88.0,88.0,,89,4320,13,9501341,162589,74769,501,9576110,163090,2,175911,4250368,53970,2796337,18611,7046705,72581,145,7,11,77799,True
89,89.0,89.0,89.0,89.0,,90,4320,13,11046487,168168,73896,501,11120383,168669,2,181917,4742434,57021,2196413,14617,6938847,71638,127,7,10,76335,True
90,90.0,90.0,90.0,,,91,720,11,3036036,51261,75482,501,3111518,51762,2,56116,1963103,24911,1888541,12580,3851644,37491,90,6,8,35168,True
91,91.0,91.0,91.0,,,92,720,11,2380550,47270,74735,501,2455285,47771,2,51759,2456410,31145,2718431,18084,5174841,49229,110,6,10,44490,True
92,92.0,92.0,92.0,,,93,720,11,2090297,45803,75834,501,2166131,46304,2,50175,2426345,31478,2715118,18077,5141463,49555,110,6,10,45011,True
93,93.0,93.0,93.0,,,94,640,11,2915196,32584,75723,501,2990919,33085,2,35587,987325,11961,1886944,12581,2874269,24542,96,6,9,21797,True
94,94.0,94.0,94.0,,,95,640,11,1133214,21586,75756,501,1208970,22087,2,23575,705276,8869,1879847,12561,2585123,21430,92,6,9,16165,True
95,95.0,95.0,95.0,,,96,640,11,1663902,24970,75354,501,1739256,25471,2,27271,368420,4930,1665961,11080,2034381,16010,91,6,9,12625,True
96,96.0,96.0,96.0,,,97,1200,11,4288470,78933,73887,501,4362357,79434,2,86345,2797747,33962,2571038,17097,5368785,51059,119,6,10,53309,True
97,97.0,97.0,97.0,,,98,1200,11,4673610,80743,75110,501,4748720,81244,2,88325,4056309,45993,2185537,14590,6241846,60583,125,6,10,68946,True
98,98.0,98.0,98.0,,,99,1200,11,4557367,78752,75131,501,4632498,79253,2,86147,3508942,40317,2714974,18098,6223916,58415,123,6,10,61105,True
99,99.0,99.0,99.0,,,100,1080,11,3304409,46061,75407,501,3379816,46562,2,50351,465571,6728,835617,5567,1301188,12295,60,6,5,10942,True
100,100.0,100.0,100.0,,,101,1080,11,2643561,43324,74364,501,2717925,43825,2,47359,550840,7249,836947,5579,1387787,12828,60,6,5,11812,True
101,101.0,101.0,101.0,,,102,1080,11,1413355,34469,75159,501,1488514,34970,2,37679,721275,8293,837265,5575,1558540,13868,60,6,5,13473,True
102,102.0,102.0,102.0,,,103,640,11,1298708,23137,76127,501,1374835,23638,2,25269,356275,4292,537109,3565,893384,7857,49,6,4,7718,True
103,103.0,103.0,103.0,,,104,640,11,2147637,28354,74870,501,2222507,28855,2,30967,257344,3623,536623,3563,793967,7186,49,6,4,6643,True
104,104.0,104.0,104.0,,,105,640,11,1908585,27085,74889,501,1983474,27586,2,29581,359575,4333,541178,3580,900753,7913,49,6,4,7840,True
105,105.0,105.0,105.0,,,106,3200,11,45441662,741222,74403,502,45516065,741724,3,817013,3925892,49100,2864922,19086,6790814,68186,129,6,11,73283,True
106,106.0,106.0,106.0,,,107,3200,11,38869530,752176,75581,504,38945111,752680,3,824515,3392386,41288,3015140,20092,6407526,61380,125,6,10,65004,True
107,107.0,107.0,107.0,,,108,3200,11,42678667,742625,75101,504,42753768,743129,3,817497,3623597,45846,2565662,17094,6189259,62940,118,6,10,67538,True
108,108.0,108.0,108.0,,,109,1620,11,3124688,52194,75952,501,3200640,52695,2,57284,2533697,32968,1582513,10584,4116210,43552,103,6,9,47952,True
109,109.0,109.0,109.0,,,110,1620,11,2346916,46927,74747,501,2421663,47428,2,51641,2353688,29531,1731998,11589,4085686,41120,94,6,8,44318,True
110,110.0,110.0,110.0,,,111,1620,11,3882484,56493,74500,501,3956984,56994,2,62091,2493879,30567,2040490,13589,4534369,44156,105,6,9,47118,True
111,111.0,111.0,111.0,,,112,1080,11,1731447,35523,75779,501,1807226,36024,2,38912,2015680,25679,1513127,10084,3528807,35763,88,6,8,35973,True
112,112.0,112.0,112.0,,,113,1080,11,1102127,28632,75625,501,1177752,29133,2,31343,1717695,21827,1746980,11584,3464675,33411,93,6,8,32490,True
113,113.0,113.0,113.0,,,114,1080,11,1482975,30409,74931,501,1557906,30910,2,33279,2358641,28674,2042961,13583,4401602,42257,101,6,9,40735,True
114,114.0,114.0,114.0,,,115,1200,11,1798371,41047,74980,501,1873351,41548,2,45162,1021756,12625,1659572,11070,2681328,23695,109,6,9,26137,True
115,115.0,115.0,115.0,,,116,1200,11,4090565,53179,74574,501,4165139,53680,2,58329,796627,10418,1513363,10077,2309990,20495,103,6,9,22732,True
116,116.0,116.0,116.0,,,117,1200,11,3901401,54878,75399,501,3976800,55379,2,60210,1628394,19234,2037720,13591,3666114,32825,109,6,9,35487,True
117,117.0,117.0,117.0,,,118,3072,11,2236379,52822,74625,501,2311004,53323,2,57833,696657,8637,841267,5602,1537924,14239,60,6,5,14337,True
118,118.0,118.0,118.0,,,119,3072,11,3299846,58220,76277,501,3376123,58721,2,63773,716642,8697,840444,5588,1557086,14285,60,6,5,14484,True
119,119.0,119.0,119.0,,,120,3072,11,4144676,60395,74156,501,4218832,60896,2,66149,604424,7941,840431,5596,1444855,13537,60,6,5,13174,True
120,120.0,120.0,,,,121,300,9,2608688,50173,75293,501,2683981,50674,2,56319,2035333,25650,2337702,15573,4373035,41223,83,5,9,38290,True
121,121.0,121.0,,,,122,300,9,1521866,47464,74753,501,1596619,47965,2,53295,2537166,32695,1430936,9573,3968102,42268,62,5,7,43879,True
122,122.0,122.0,,,,123,300,9,1629503,46453,73559,501,1703062,46954,2,52143,2393410,29971,2187647,14577,4581057,44548,87,5,9,44842,True
123,123.0,123.0,,,,124,600,9,1569206,18177,76160,501,1645366,18678,2,20253,226630,2702,309285,2045,535915,4747,31,5,3,4718,True
124,124.0,124.0,,,,125,600,9,624956,11766,74926,501,699882,12267,2,13116,188574,2562,308550,2048,497124,4610,32,5,3,5111,True
125,125.0,125.0,,,,126,600,9,1720196,19122,74415,501,1794611,19623,2,21306,201580,2656,307550,2055,509130,4711,32,5,3,5021,True
126,126.0,126.0,,,,127,184,9,785598,14692,75448,501,861046,15193,2,16393,326459,4015,533552,3551,860011,7566,41,5,4,7801,True
127,127.0,127.0,,,,128,184,9,1202968,18757,75844,501,1278812,19258,2,20939,521170,5716,534721,3549,1055891,9265,41,5,4,10366,True
128,128.0,128.0,,,,129,184,9,2168235,24204,73915,501,2242150,24705,2,27014,306061,4022,532185,3548,838246,7570,39,5,4,7211,True
129,129.0,129.0,,,,130,240,9,1079182,26271,75832,501,1155014,26772,2,29309,752433,9425,838096,5564,1590529,14989,54,5,5,17254,True
130,130.0,130.0,,,,131,240,9,2355118,43816,75502,504,2430620,44320,3,48884,707820,8326,834493,5557,1542313,13883,53,5,5,16158,True
131,131.0,131.0,,,,132,240,9,1417074,29398,75907,501,1492981,29899,2,32819,482684,6601,835092,5557,1317776,12158,51,5,5,12787,True
132,132.0,132.0,,,,133,180,9,1433091,18702,75328,501,1508419,19203,2,20838,1177605,14270,1283294,8552,2460899,22822,60,5,7,19125,True
133,133.0,133.0,,,,134,180,9,1092451,15822,75007,501,1167458,16323,2,17615,1492823,18884,1210632,8053,2703455,26937,57,5,7,24779,True
134,134.0,134.0,,,,135,180,9,1108995,16113,74831,501,1183826,16614,2,17939,2457936,26520,1290739,8570,3748675,35090,68,5,8,34520,True
135,135.0,135.0,,,,136,480,9,2033083,31739,75700,502,2108783,32241,3,35545,330891,4251,530610,3546,861501,7797,41,5,4,7605,True
136,136.0,136.0,,,,137,480,9,3449181,40971,75456,502,3524637,41473,3,45877,206811,2711,536301,3563,743112,6274,39,5,4,5311,True
137,137.0,137.0,,,,138,480,9,704496,13977,76017,501,780513,14478,2,15573,222848,2847,531390,3553,754238,6400,39,5,4,5418,True
138,138.0,138.0,,,,139,1000,9,1499255,25822,74898,501,1574153,26323,2,28933,1739389,22324,1061299,7065,2800688,29389,72,5,7,35233,True
139,139.0,139.0,,,,140,1000,9,987861,21373,75815,501,1063676,21874,2,23884,2461124,27358,987234,6559,3448358,33917,72,5,7,42075,True
140,140.0,140.0,,,,141,1000,9,2341044,29308,75001,501,2416045,29809,2,32758,2481085,27791,983854,6564,3464939,34355,72,5,7,42829,True
141,141.0,141.0,,,,142,132,9,1506144,22030,74560,501,1580704,22531,2,24527,841806,10064,1961098,13054,2802904,23118,64,5,8,13538,True
142,142.0,142.0,,,,143,132,9,1590491,22321,75671,501,1666162,22822,2,24851,1133030,13650,1965826,13065,3098856,26715,69,5,8,19397,True
143,143.0,143.0,,,,144,132,9,1421858,21545,75504,501,1497362,22046,2,23987,951497,12170,2336235,15569,3287732,27739,75,5,9,17258,True
144,144.0,144.0,,,,145,384,9,1066796,15833,75527,501,1142323,16334,2,17653,1313958,16257,763583,5061,2077541,21318,59,5,6,23860,True
145,145.0,145.0,,,,146,384,9,1871521,20916,75844,501,1947365,21417,2,23323,1054942,14264,761976,5062,1816918,19326,57,5,6,21554,True
146,146.0,146.0,,,,147,384,9,991312,15604,75373,501,1066685,16105,2,17401,1301442,16149,616198,4071,1917640,20220,54,5,6,21926,True
147,147.0,147.0,,,,148,400,9,5536977,72088,77344,512,5614321,72600,3,81231,666404,8135,841818,5579,1508222,13714,50,5,5,14891,True
148,148.0,148.0,,,,149,400,9,2706355,53163,75002,502,2781357,53665,3,59919,401608,5382,832085,5553,1233693,10935,48,5,5,10290,True
149,149.0,149.0,,,,150,400,9,3526235,61022,74933,504,3601168,61526,3,69019,978440,11960,841732,5570,1820172,17530,54,5,5,21460,True
150,150.0,,,,,151,180,7,431885,10173,75289,501,507174,10674,2,11751,905636,9449,758180,5045,1663816,14494,39,4,5,13653,True
151,151.0,,,,,152,180,7,822322,13561,74942,501,897264,14062,2,15664,1381381,15962,836376,5557,2217757,21519,46,4,6,22416,True
152,152.0,,,,,153,180,7,855122,13646,74977,501,930099,14147,2,15755,1136194,13857,833221,5547,1969415,19404,45,4,6,19493,True
153,153.0,,,,,154,144,7,1091811,21775,74673,501,1166484,22276,2,25199,1467366,18752,1287434,8551,2754800,27303,64,4,7,31474,True
154,154.0,,,,,155,144,7,916731,20158,74661,501,991392,20659,2,23239,1440095,18674,1285275,8565,2725370,27239,65,4,7,31258,True
155,155.0,,,,,156,144,7,591794,18067,75179,501,666973,18568,2,20887,1704145,20500,1134998,7571,2839143,28071,67,4,7,34045,True
156,156.0,,,,,157,375,7,1912515,49361,75717,501,1988232,49862,2,58103,1407314,19125,1284529,8552,2691843,27677,61,4,7,30209,True
157,157.0,,,,,158,375,7,2190388,50664,75233,501,2265621,51165,2,59111,1634158,20930,1284803,8558,2918961,29488,61,4,7,33389,True
158,158.0,,,,,159,375,7,1663352,45189,75334,501,1738686,45690,2,53328,1641934,20265,986280,6562,2628214,26827,51,4,6,30571,True
159,159.0,,,,,160,198,7,1559376,25419,75670,501,1635046,25920,2,29413,1463573,18013,1140492,7570,2604065,25583,59,4,7,28712,True
160,160.0,,,,,161,198,7,1352412,23851,74793,501,1427205,24352,2,27649,1867941,20895,1136040,7574,3003981,28469,59,4,7,32527,True
161,161.0,,,,,162,198,7,878140,22604,73883,501,952023,23105,2,26179,1474597,16333,1439173,9555,2913770,25888,61,4,7,28665,True
162,162.0,,,,,163,200,7,1097722,15892,75925,501,1173647,16393,2,18339,1263113,15504,907074,6049,2170187,21553,51,4,6,24527,True
163,163.0,,,,,164,200,7,1383253,17234,75497,501,1458750,17735,2,19907,1706049,18940,611073,4051,2317122,22991,39,4,5,27136,True
164,164.0,,,,,165,200,7,1261394,16465,75079,501,1336473,16966,2,19025,1379581,15815,987738,6552,2367319,22367,53,4,6,25091,True
165,165.0,,,,,166,240,7,1094042,12781,74548,501,1168590,13282,2,14711,251088,3082,306367,2039,557455,5121,24,4,3,5202,True
166,166.0,,,,,167,240,7,1106711,12854,75174,501,1181885,13355,2,14795,162875,2407,306588,2043,469463,4450,24,4,3,4051,True
167,167.0,,,,,168,240,7,651139,9933,75912,501,727051,10434,2,11435,216732,2770,308293,2047,525025,4817,24,4,3,4646,True
168,168.0,,,,,169,200,7,1340132,16523,75668,501,1415800,17024,2,19031,466421,5642,531252,3552,997673,9194,34,4,4,10111,True
169,169.0,,,,,170,200,7,860712,13587,74463,501,935175,14088,2,15664,456104,5574,533544,3550,989648,9124,33,4,4,9454,True
170,170.0,,,,,171,200,7,628519,11847,75413,501,703932,12348,2,13662,490774,5907,537486,3549,1028260,9456,35,4,4,11026,True
171,171.0,,,,,172,160,7,1237453,13745,75330,501,1312783,14246,2,15795,297843,3904,532498,3546,830341,7450,31,4,4,6480,True
172,172.0,,,,,173,160,7,1276309,13946,75447,501,1351756,14447,2,16026,354761,4385,533575,3556,888336,7941,31,4,4,7314,True
173,173.0,,,,,174,160,7,535180,9323,74999,501,610179,9824,2,10713,417443,4686,533761,3548,951204,8234,31,4,4,7830,True
174,174.0,,,,,175,375,7,1545288,23884,74941,501,1620229,24385,2,27791,1204767,15502,834953,5556,2039720,21058,48,4,6,23294,True
175,175.0,,,,,176,375,7,594479,17378,74391,501,668870,17879,2,20175,1421071,16721,764919,5066,2185990,21787,42,4,5,25332,True
176,176.0,,,,,177,375,7,2717085,36554,75279,502,2792364,37056,3,43023,1210897,15746,608026,4049,1818923,19795,40,4,5,24043,True
177,177.0,,,,,178,180,7,877896,20971,75485,501,953381,21472,2,24317,1289135,16956,1362857,9058,2651992,26014,65,4,7,27521,True
178,178.0,,,,,179,180,7,840658,20185,75596,501,916254,20686,2,23337,1306333,17090,1438466,9560,2744799,26650,63,4,7,28266,True
179,179.0,,,,,180,180,7,1862977,26031,74898,501,1937875,26532,2,30099,1380787,17675,1439984,9565,2820771,27240,64,4,7,28493,True
180,,,,,,181,100,5,836825,8250,75173,501,911998,8751,2,10059,474093,5802,455735,3031,929828,8833,24,3,4,9138,True
181,,,,,,182,100,5,386513,5626,75595,501,462108,6127,2,6859,415411,5365,455587,3033,870998,8398,24,3,4,8660,True
182,,,,,,183,100,5,406210,5913,75607,501,481817,6414,2,7209,205120,3127,305847,2033,510967,5160,18,3,3,4880,True
183,,,,,,184,125,5,463234,9370,74607,501,537841,9871,2,11633,1116092,12236,755126,5039,1871218,17275,36,3,5,21980,True
184,,,,,,185,125,5,1176331,14000,75641,501,1251972,14501,2,17303,961055,11490,679520,4541,1640575,16031,34,3,5,19830,True
185,,,,,,186,125,5,1078645,13102,74954,501,1153599,13603,2,16253,790559,10355,684988,4541,1475547,14896,37,3,5,18640,True
186,,,,,,187,100,5,815489,9885,74580,501,890069,10386,2,12131,684124,8747,530363,3536,1214487,12283,27,3,4,13962,True
187,,,,,,188,100,5,865229,9972,76343,501,941572,10473,2,12251,926079,10386,756771,5035,1682850,15421,35,3,5,17509,True
188,,,,,,189,100,5,597999,8995,75285,501,673284,9496,2,11062,812419,9808,682591,4539,1495010,14347,32,3,5,15667,True
189,,,,,,190,125,5,1045864,12050,74963,501,1120827,12551,2,14832,1106904,12175,759489,5041,1866393,17216,35,3,5,21462,True
190,,,,,,191,125,5,412875,9190,74900,501,487775,9691,2,11387,828797,10260,757182,5045,1585979,15305,35,3,5,18005,True
191,,,,,,192,125,5,680566,10095,74144,501,754710,10596,2,12427,711850,9721,759338,5042,1471188,14763,35,3,5,17403,True
192,,,,,,193,100,5,383762,4704,76135,501,459897,5205,2,5676,172344,2409,228846,1524,401190,3933,17,3,3,3589,True
193,,,,,,194,100,5,320467,4269,75548,501,396015,4770,2,5151,128474,1692,155006,1032,283480,2724,11,3,2,2326,True
194,,,,,,195,100,5,588233,6211,75185,501,663418,6712,2,7527,143155,2064,232627,1534,375782,3598,17,3,3,3074,True
195,,,,,,196,100,5,856300,12235,76055,501,932355,12736,2,15071,979688,10765,531746,3539,1511434,14304,29,3,4,18224,True
196,,,,,,197,100,5,502271,10506,74011,501,576282,11007,2,13012,995396,11217,681422,4537,1676818,15754,37,3,5,20192,True
197,,,,,,198,100,5,777497,11501,74604,501,852101,12002,2,14171,870148,10435,608300,4044,1478448,14479,37,3,5,19057,True
198,,,,,,199,100,5,763366,11021,74732,501,838098,11522,2,13663,889077,10639,684938,4541,1574015,15180,33,3,5,17104,True
199,,,,,,200,100,5,443686,9323,75515,501,519201,9824,2,11563,712822,9225,680538,4535,1393360,13760,36,3,5,16663,True
200,,,,,,201,100,5,849960,11784,74920,501,924880,12285,2,14503,879302,10615,755346,5041,1634648,15656,36,3,5,18255,True
201,,,,,,202,100,5,543753,8308,75377,501,619130,8809,2,10217,628062,8443,753718,5035,1381780,13478,33,3,5,13717,True
202,,,,,,203,100,5,860382,10024,74506,501,934888,10525,2,12311,808619,9325,678882,4538,1487501,13863,32,3,5,14597,True
203,,,,,,204,100,5,732179,9481,74964,501,807143,9982,2,11647,718713,9190,608470,4036,1327183,13226,30,3,5,14083,True
204,,,,,,205,115,5,704028,8635,76080,501,780108,9136,2,10570,424307,5112,684861,4544,1109168,9656,33,3,5,10880,True
205,,,,,,206,115,5,778956,9144,73220,501,852176,9645,2,11175,367349,4820,683320,4530,1050669,9350,33,3,5,10034,True
206,,,,,,207,115,5,511671,7466,75304,501,586975,7967,2,9140,451567,5394,758743,5034,1210310,10428,34,3,5,11430,True
207,,,,,,208,100,5,722023,8155,75402,501,797425,8656,2,9959,780386,9790,382458,2551,1162844,12341,29,3,4,15573,True
208,,,,,,209,100,5,385551,6535,74907,501,460458,7036,2,7985,766074,8313,456223,3041,1222297,11354,29,3,4,14245,True
209,,,,,,210,100,5,767097,8965,76800,501,843897,9466,2,10955,331860,4679,304550,2030,636410,6709,20,3,3,7826,True
