,Unnamed: 0.10,Unnamed: 0.9,Unnamed: 0.8,Unnamed: 0.7,Unnamed: 0.6,Unnamed: 0.5,Unnamed: 0.4,Unnamed: 0.3,Unnamed: 0.2,Unnamed: 0.1,Unnamed: 0,FILE_NAME,STATES,INPUTS,LSTAR_MQ_SYM,LSTAR_MQ_RST,LSTAR_EQ_SYM,LSTAR_EQ_RST,LSTAR_TOTAL_SYM,LSTAR_TOTAL_RST,LSTAR_EQs,LSTAR_MQs,CLSTAR_MQ_SYM,CLSTAR_MQ_RST,CLSTAR_EQ_SYM,CLSTAR_EQ_RST,CLSTAR_TOTAL_SYM,CLSTAR_TOTAL_RST,CLSTAR_EQs,CLSTAR_COMPONENTS,CLSTAR_ROUNDS,CLSTAR_MQs,CACHE
0,0.0,0.0,0.0,0.0,0.0,0.0,0.0,0.0,0.0,0.0,0.0,1,120,5,792462,10992,74887,501,867349,11493,2,13485,458934,5589,530216,3532,989150,9121,28,3,4,10037,True
1,1.0,1.0,1.0,1.0,1.0,1.0,1.0,1.0,1.0,1.0,1.0,2,120,5,974712,11082,74476,501,1049188,11583,2,13595,483795,5855,532058,3532,1015853,9387,30,3,4,11833,True
2,2.0,2.0,2.0,2.0,2.0,2.0,2.0,2.0,2.0,2.0,2.0,3,120,5,694535,10069,74957,501,769492,10570,2,12385,386292,5098,528806,3533,915098,8631,30,3,4,10186,True
3,3.0,3.0,3.0,3.0,3.0,3.0,3.0,3.0,3.0,3.0,3.0,4,100,5,1137396,15647,75414,504,1212810,16151,3,19425,578488,7479,539763,3602,1118251,11081,30,3,4,14209,True
4,4.0,4.0,4.0,4.0,4.0,4.0,4.0,4.0,4.0,4.0,4.0,5,100,5,1429866,17942,80303,541,1510169,18483,3,22175,565187,6584,534130,3550,1099317,10134,27,3,4,11503,True
5,5.0,5.0,5.0,5.0,5.0,5.0,5.0,5.0,5.0,5.0,5.0,6,100,5,600013,9413,74869,501,674882,9914,2,11560,430159,5708,536968,3560,967127,9268,28,3,4,10628,True
6,6.0,6.0,6.0,6.0,6.0,6.0,6.0,6.0,6.0,6.0,6.0,7,125,5,1095715,13156,75472,501,1171187,13657,2,16132,501555,6118,528492,3534,1030047,9652,32,3,4,12861,True
7,7.0,7.0,7.0,7.0,7.0,7.0,7.0,7.0,7.0,7.0,7.0,8,125,5,430268,9251,75698,501,505966,9752,2,11387,551318,6459,530087,3538,1081405,9997,30,3,4,12629,True
8,8.0,8.0,8.0,8.0,8.0,8.0,8.0,8.0,8.0,8.0,8.0,9,125,5,803620,11195,74903,501,878523,11696,2,13727,557885,6579,530881,3527,1088766,10106,34,3,4,15244,True
9,9.0,9.0,9.0,9.0,9.0,9.0,9.0,9.0,9.0,9.0,9.0,10,100,5,829967,9537,74923,501,904890,10038,2,11670,394581,5080,532422,3539,927003,8619,27,3,4,8928,True
10,10.0,10.0,10.0,10.0,10.0,10.0,10.0,10.0,10.0,10.0,10.0,11,100,5,697892,8820,75515,501,773407,9321,2,10790,363687,4912,532347,3543,896034,8455,26,3,4,8429,True
11,11.0,11.0,11.0,11.0,11.0,11.0,11.0,11.0,11.0,11.0,11.0,12,100,5,442886,7730,75395,501,518281,8231,2,9470,500170,5701,531901,3530,1032071,9231,28,3,4,10330,True
12,12.0,12.0,12.0,12.0,12.0,12.0,12.0,12.0,12.0,12.0,12.0,13,125,5,327815,6850,74607,501,402422,7351,2,8370,490536,5854,530208,3529,1020744,9383,28,3,4,11060,True
13,13.0,13.0,13.0,13.0,13.0,13.0,13.0,13.0,13.0,13.0,13.0,14,125,5,342155,6580,75475,501,417630,7081,2,8040,399319,5230,532965,3539,932284,8769,28,3,4,9727,True
14,14.0,14.0,14.0,14.0,14.0,14.0,14.0,14.0,14.0,14.0,14.0,15,125,5,789309,9775,75763,501,865072,10276,2,11945,476633,5621,530862,3529,1007495,9150,31,3,4,11616,True
15,15.0,15.0,15.0,15.0,15.0,15.0,15.0,15.0,15.0,15.0,15.0,16,105,5,323737,4792,74795,501,398532,5293,2,5807,400932,4444,531727,3530,932659,7974,26,3,4,7867,True
16,16.0,16.0,16.0,16.0,16.0,16.0,16.0,16.0,16.0,16.0,16.0,17,105,5,494169,5947,75440,501,569609,6448,2,7207,286586,3410,532280,3534,818866,6944,27,3,4,6657,True
17,17.0,17.0,17.0,17.0,17.0,17.0,17.0,17.0,17.0,17.0,17.0,18,105,5,462178,7861,76319,504,538497,8365,3,9527,310148,3910,530240,3539,840388,7449,26,3,4,6937,True
18,18.0,18.0,18.0,18.0,18.0,18.0,18.0,18.0,18.0,18.0,18.0,19,100,5,1038856,12231,75122,501,1113978,12732,2,15063,436042,5601,530158,3529,966200,9130,29,3,4,10781,True
19,19.0,19.0,19.0,19.0,19.0,19.0,19.0,19.0,19.0,19.0,19.0,20,100,5,320116,7608,74865,501,394981,8109,2,9371,448891,5664,531741,3537,980632,9201,29,3,4,10671,True
20,20.0,20.0,20.0,20.0,20.0,20.0,20.0,20.0,20.0,20.0,20.0,21,100,5,1010311,11888,75094,501,1085405,12389,2,14637,552867,6289,532708,3538,1085575,9827,30,3,4,12235,True
21,21.0,21.0,21.0,21.0,21.0,21.0,21.0,21.0,21.0,21.0,21.0,22,120,5,1418263,21504,75372,503,1493635,22007,3,26662,447555,5955,533743,3532,981298,9487,32,3,4,12363,True
22,22.0,22.0,22.0,22.0,22.0,22.0,22.0,22.0,22.0,22.0,22.0,23,120,5,1660681,21775,74710,502,1735391,22277,3,26951,507054,5928,528057,3534,1035111,9462,31,3,4,12070,True
23,23.0,23.0,23.0,23.0,23.0,23.0,23.0,23.0,23.0,23.0,23.0,24,120,5,880972,14196,74717,501,955689,14697,2,17497,475819,5971,531683,3535,1007502,9506,31,3,4,12053,True
24,24.0,24.0,24.0,24.0,24.0,24.0,24.0,24.0,24.0,24.0,24.0,25,105,5,818689,12588,76111,501,894800,13089,2,15482,553257,7197,533879,3545,1087136,10742,31,3,4,13142,True
25,25.0,25.0,25.0,25.0,25.0,25.0,25.0,25.0,25.0,25.0,25.0,26,105,5,591715,11123,75139,501,666854,11624,2,13662,513814,6085,532330,3541,1046144,9626,29,3,4,11414,True
26,26.0,26.0,26.0,26.0,26.0,26.0,26.0,26.0,26.0,26.0,26.0,27,105,5,742892,12396,76100,501,818992,12897,2,15287,599878,7033,534108,3537,1133986,10570,27,3,4,12202,True
27,27.0,27.0,27.0,27.0,27.0,27.0,27.0,27.0,27.0,27.0,27.0,28,100,5,1080952,16525,75673,509,1156625,17034,3,20195,384419,4937,531425,3534,915844,8471,29,3,4,10080,True
28,28.0,28.0,28.0,28.0,28.0,28.0,28.0,28.0,28.0,28.0,28.0,29,100,5,765096,11252,74459,501,839555,11753,2,13870,462481,5637,534220,3545,996701,9182,28,3,4,10661,True
29,29.0,29.0,29.0,29.0,29.0,29.0,29.0,29.0,29.0,29.0,29.0,30,100,5,1123667,16806,75687,502,1199354,17308,3,20855,361573,4950,535542,3554,897115,8504,28,3,4,9851,True
30,30.0,30.0,30.0,30.0,30.0,30.0,30.0,30.0,30.0,30.0,30.0,31,144,6,1337341,19444,74472,501,1411813,19945,2,23029,600208,7953,828886,5534,1429094,13487,39,4,5,14499,True
31,31.0,31.0,31.0,31.0,31.0,31.0,31.0,31.0,31.0,31.0,31.0,32,144,6,582045,15170,75361,501,657406,15671,2,17989,782768,9176,839099,5555,1621867,14731,39,4,5,16344,True
32,32.0,32.0,32.0,32.0,32.0,32.0,32.0,32.0,32.0,32.0,32.0,33,144,6,2496242,31326,77268,504,2573510,31830,3,37645,559673,6308,833888,5541,1393561,11849,38,4,5,12659,True
33,33.0,33.0,33.0,33.0,33.0,33.0,33.0,33.0,33.0,33.0,33.0,34,135,6,1029123,14205,75441,501,1104564,14706,2,16787,554968,7289,834593,5547,1389561,12836,39,4,5,12099,True
34,34.0,34.0,34.0,34.0,34.0,34.0,34.0,34.0,34.0,34.0,34.0,35,135,6,1175511,14933,74973,501,1250484,15434,2,17651,671902,8224,834271,5547,1506173,13771,43,4,5,14936,True
35,35.0,35.0,35.0,35.0,35.0,35.0,35.0,35.0,35.0,35.0,35.0,36,135,6,453934,10360,74222,501,528156,10861,2,12251,579891,7461,837104,5546,1416995,13007,39,4,5,12461,True
36,36.0,36.0,36.0,36.0,36.0,36.0,36.0,36.0,36.0,36.0,36.0,37,250,6,1025642,23017,76267,501,1101909,23518,2,27554,728972,8613,833260,5547,1562232,14160,43,4,5,17763,True
37,37.0,37.0,37.0,37.0,37.0,37.0,37.0,37.0,37.0,37.0,37.0,38,250,6,1103593,25449,74355,501,1177948,25950,2,30159,474019,6105,831011,5542,1305030,11647,41,4,5,13751,True
38,38.0,38.0,38.0,38.0,38.0,38.0,38.0,38.0,38.0,38.0,38.0,39,250,6,1673765,27006,75336,501,1749101,27507,2,32367,630852,7236,833126,5540,1463978,12776,41,4,5,15714,True
39,39.0,39.0,39.0,39.0,39.0,39.0,39.0,39.0,39.0,39.0,39.0,40,180,6,1326797,17416,75155,501,1401952,17917,2,20677,650507,8339,831348,5547,1481855,13886,40,4,5,14431,True
40,40.0,40.0,40.0,40.0,40.0,40.0,40.0,40.0,40.0,40.0,40.0,41,180,6,1016428,16505,75272,501,1091700,17006,2,19669,691896,8385,833262,5546,1525158,13931,41,4,5,14504,True
41,41.0,41.0,41.0,41.0,41.0,41.0,41.0,41.0,41.0,41.0,41.0,42,180,6,934339,15425,75423,501,1009762,15926,2,18409,668902,8341,834843,5549,1503745,13890,41,4,5,14283,True
42,42.0,42.0,42.0,42.0,42.0,42.0,42.0,42.0,42.0,42.0,42.0,43,180,6,845588,16115,74589,501,920177,16616,2,19019,780534,9161,831634,5542,1612168,14703,46,4,5,18356,True
43,43.0,43.0,43.0,43.0,43.0,43.0,43.0,43.0,43.0,43.0,43.0,44,180,6,852211,15566,76357,501,928568,16067,2,18371,740776,8691,832813,5549,1573589,14240,46,4,5,17655,True
44,44.0,44.0,44.0,44.0,44.0,44.0,44.0,44.0,44.0,44.0,44.0,45,180,6,1030695,15810,75608,501,1106303,16311,2,18659,784941,9198,832778,5549,1617719,14747,46,4,5,17717,True
45,45.0,45.0,45.0,45.0,45.0,45.0,45.0,45.0,45.0,45.0,45.0,46,100,6,756301,11545,75218,501,831519,12046,2,13691,666423,7372,835237,5554,1501660,12926,37,4,5,14707,True
46,46.0,46.0,46.0,46.0,46.0,46.0,46.0,46.0,46.0,46.0,46.0,47,100,6,1101756,14158,75732,501,1177488,14659,2,16782,252086,3339,828435,5534,1080521,8873,35,4,5,8703,True
47,47.0,47.0,47.0,47.0,47.0,47.0,47.0,47.0,47.0,47.0,47.0,48,100,6,441262,10715,75065,501,516327,11216,2,12726,566205,6567,830327,5538,1396532,12105,38,4,5,13548,True
48,48.0,48.0,48.0,48.0,48.0,48.0,48.0,48.0,48.0,48.0,48.0,49,378,6,1908964,26435,75680,501,1984644,26936,2,31503,946637,10600,836290,5551,1782927,16151,41,4,5,19143,True
49,49.0,49.0,49.0,49.0,49.0,49.0,49.0,49.0,49.0,49.0,49.0,50,378,6,602101,17335,76166,501,678267,17836,2,20804,800110,9469,835073,5541,1635183,15010,39,4,5,16157,True
50,50.0,50.0,50.0,50.0,50.0,50.0,50.0,50.0,50.0,50.0,50.0,51,378,6,1023339,21385,74158,501,1097497,21886,2,25551,726599,9240,831240,5544,1557839,14784,40,4,5,15917,True
51,51.0,51.0,51.0,51.0,51.0,51.0,51.0,51.0,51.0,51.0,51.0,52,225,6,1226413,19495,75258,501,1301671,19996,2,23281,637578,8390,833339,5548,1470917,13938,42,4,5,14740,True
52,52.0,52.0,52.0,52.0,52.0,52.0,52.0,52.0,52.0,52.0,52.0,53,225,6,1560492,21914,75335,501,1635827,22415,2,26053,768578,9434,829316,5542,1597894,14976,46,4,5,18606,True
53,53.0,53.0,53.0,53.0,53.0,53.0,53.0,53.0,53.0,53.0,53.0,54,225,6,1588544,21324,75566,501,1664110,21825,2,25381,736438,8727,833612,5544,1570050,14271,42,4,5,15587,True
54,54.0,54.0,54.0,54.0,54.0,54.0,54.0,54.0,54.0,54.0,54.0,55,160,6,972166,15200,75347,501,1047513,15701,2,17939,454113,6066,835004,5537,1289117,11603,40,4,5,12439,True
55,55.0,55.0,55.0,55.0,55.0,55.0,55.0,55.0,55.0,55.0,55.0,56,160,6,440072,11643,75382,501,515454,12144,2,13763,524108,6975,835042,5543,1359150,12518,39,4,5,13731,True
56,56.0,56.0,56.0,56.0,56.0,56.0,56.0,56.0,56.0,56.0,56.0,57,160,6,512780,11418,76161,501,588941,11919,2,13475,495029,5916,836302,5551,1331331,11467,39,4,5,13244,True
57,57.0,57.0,57.0,57.0,57.0,57.0,57.0,57.0,57.0,57.0,57.0,58,160,6,789975,10770,75853,501,865828,11271,2,12669,552975,6834,833101,5547,1386076,12381,41,4,5,12033,True
58,58.0,58.0,58.0,58.0,58.0,58.0,58.0,58.0,58.0,58.0,58.0,59,160,6,501771,8883,75827,501,577598,9384,2,10449,373337,5106,830050,5549,1203387,10655,38,4,5,9503,True
59,59.0,59.0,59.0,59.0,59.0,59.0,59.0,59.0,59.0,59.0,59.0,60,160,6,478076,8736,75035,501,553111,9237,2,10306,573656,6712,838487,5548,1412143,12260,41,4,5,12534,True
60,60.0,60.0,60.0,60.0,60.0,60.0,60.0,60.0,60.0,60.0,,61,450,8,1819534,46616,75798,501,1895332,47117,2,53263,884723,10514,1210648,8066,2095371,18580,60,5,6,19813,True
61,61.0,61.0,61.0,61.0,61.0,61.0,61.0,61.0,61.0,61.0,,62,450,8,3099652,50654,74441,501,3174093,51155,2,57871,1034811,12544,1216398,8064,2251209,20608,59,5,6,21763,True
62,62.0,62.0,62.0,62.0,62.0,62.0,62.0,62.0,62.0,62.0,,63,450,8,1518767,45228,74984,501,1593751,45729,2,51727,864309,10600,1207398,8063,2071707,18663,55,5,6,18019,True
63,63.0,63.0,63.0,63.0,63.0,63.0,63.0,63.0,63.0,63.0,,64,168,8,755012,24393,74728,501,829740,24894,2,27677,396942,5067,1213065,8049,1610007,13116,49,5,6,8597,True
64,64.0,64.0,64.0,64.0,64.0,64.0,64.0,64.0,64.0,64.0,,65,168,8,1581838,30966,75658,501,1657496,31467,2,35054,531076,6284,1206959,8070,1738035,14354,50,5,6,10629,True
65,65.0,65.0,65.0,65.0,65.0,65.0,65.0,65.0,65.0,65.0,,66,168,8,2247100,34782,74971,501,2322071,35283,2,39374,843816,9474,1208211,8055,2052027,17529,53,5,6,15822,True
66,66.0,66.0,66.0,66.0,66.0,66.0,66.0,66.0,66.0,66.0,,67,180,8,1620633,29166,75686,501,1696319,29667,2,32939,435985,5597,1213188,8076,1649173,13673,54,5,6,10876,True
67,67.0,67.0,67.0,67.0,67.0,67.0,67.0,67.0,67.0,67.0,,68,180,8,3323979,45911,78295,516,3402274,46427,3,51851,406463,5376,1206830,8051,1613293,13427,53,5,6,10843,True
68,68.0,68.0,68.0,68.0,68.0,68.0,68.0,68.0,68.0,68.0,,69,180,8,1181764,26786,75683,501,1257447,27287,2,30251,459987,6170,1207465,8066,1667452,14236,56,5,6,11673,True
69,69.0,69.0,69.0,69.0,69.0,69.0,69.0,69.0,69.0,69.0,,70,400,8,3065736,50418,75033,501,3140769,50919,2,57743,484561,6320,1214773,8064,1699334,14384,54,5,6,13808,True
70,70.0,70.0,70.0,70.0,70.0,70.0,70.0,70.0,70.0,70.0,,71,400,8,4815717,54197,74507,501,4890224,54698,2,61967,704756,8771,1211839,8058,1916595,16829,54,5,6,16339,True
71,71.0,71.0,71.0,71.0,71.0,71.0,71.0,71.0,71.0,71.0,,72,400,8,4197294,55951,74216,501,4271510,56452,2,63800,600710,7089,1210978,8051,1811688,15140,54,5,6,14417,True
72,72.0,72.0,72.0,72.0,72.0,72.0,72.0,72.0,72.0,72.0,,73,270,8,1724300,35157,75748,501,1800048,35658,2,39854,960039,11622,1213030,8063,2173069,19685,62,5,6,21455,True
73,73.0,73.0,73.0,73.0,73.0,73.0,73.0,73.0,73.0,73.0,,74,270,8,2289157,35473,74739,501,2363896,35974,2,40214,737391,9165,1213462,8056,1950853,17221,58,5,6,17271,True
74,74.0,74.0,74.0,74.0,74.0,74.0,74.0,74.0,74.0,74.0,,75,270,8,2814590,39945,75652,501,2890242,40446,2,45374,787509,9430,1210476,8057,1997985,17487,57,5,6,15928,True
75,75.0,75.0,75.0,75.0,75.0,75.0,75.0,75.0,75.0,75.0,,76,432,8,1835132,44110,76070,501,1911202,44611,2,49934,841105,9611,1205875,8052,2046980,17663,57,5,6,17839,True
76,76.0,76.0,76.0,76.0,76.0,76.0,76.0,76.0,76.0,76.0,,77,432,8,2507832,46972,74258,501,2582090,47473,2,53174,941051,10523,1212755,8050,2153806,18573,58,5,6,19881,True
77,77.0,77.0,77.0,77.0,77.0,77.0,77.0,77.0,77.0,77.0,,78,432,8,2167162,44428,74559,501,2241721,44929,2,50294,975831,11361,1206961,8048,2182792,19409,60,5,6,20733,True
78,78.0,78.0,78.0,78.0,78.0,78.0,78.0,78.0,78.0,78.0,,79,480,8,2975597,69376,75651,501,3051248,69877,2,78624,984202,11870,1206720,8054,2190922,19924,61,5,6,22920,True
79,79.0,79.0,79.0,79.0,79.0,79.0,79.0,79.0,79.0,79.0,,80,480,8,2608653,69488,74372,501,2683025,69989,2,79032,696166,9169,1211548,8055,1907714,17224,64,5,6,21399,True
80,80.0,80.0,80.0,80.0,80.0,80.0,80.0,80.0,80.0,80.0,,81,480,8,2651982,75138,75597,502,2727579,75640,3,85647,1050247,12649,1209038,8060,2259285,20709,63,5,6,24547,True
81,81.0,81.0,81.0,81.0,81.0,81.0,81.0,81.0,81.0,81.0,,82,480,8,3249897,62962,75724,501,3325621,63463,2,71951,628915,8782,1210165,8052,1839080,16834,57,5,6,15319,True
82,82.0,82.0,82.0,82.0,82.0,82.0,82.0,82.0,82.0,82.0,,83,480,8,2243372,59597,76577,501,2319949,60098,2,68294,683015,8452,1212012,8062,1895027,16514,56,5,6,15626,True
83,83.0,83.0,83.0,83.0,83.0,83.0,83.0,83.0,83.0,83.0,,84,480,8,2446784,65265,75412,501,2522196,65766,2,74639,571358,7821,1213690,8063,1785048,15884,56,5,6,14488,True
84,84.0,84.0,84.0,84.0,84.0,84.0,84.0,84.0,84.0,84.0,,85,180,8,2807671,38718,76343,509,2884014,39227,3,43979,227392,2869,1208702,8052,1436094,10921,51,5,6,8172,True
85,85.0,85.0,85.0,85.0,85.0,85.0,85.0,85.0,85.0,85.0,,86,180,8,1461569,23726,75964,501,1537533,24227,2,26795,230886,3232,1212659,8081,1443545,11313,52,5,6,8032,True
86,86.0,86.0,86.0,86.0,86.0,86.0,86.0,86.0,86.0,86.0,,87,180,8,1473140,29861,77510,519,1550650,30380,3,33899,233046,2948,1212386,8065,1445432,11013,51,5,6,8050,True
87,87.0,87.0,87.0,87.0,87.0,87.0,87.0,87.0,87.0,87.0,,88,210,8,1464302,20524,75424,501,1539726,21025,2,23154,263813,3356,1212087,8049,1475900,11405,49,5,6,6709,True
88,88.0,88.0,88.0,88.0,88.0,88.0,88.0,88.0,88.0,88.0,,89,210,8,1334506,19744,75277,501,1409783,20245,2,22274,371295,4590,1206909,8049,1578204,12639,49,5,6,8268,True
89,89.0,89.0,89.0,89.0,89.0,89.0,89.0,89.0,89.0,89.0,,90,210,8,465822,14050,74265,501,540087,14551,2,15850,250552,3352,1205765,8047,1456317,11399,49,5,6,6695,True
90,90.0,90.0,90.0,90.0,90.0,90.0,90.0,90.0,90.0,,,91,1520,9,4248826,228682,74573,501,4323399,229183,2,255491,1521611,18821,1654348,11073,3175959,29894,86,6,7,34287,True
91,91.0,91.0,91.0,91.0,91.0,91.0,91.0,91.0,91.0,,,92,1520,9,7121621,252172,75859,502,7197480,252674,3,281735,1178369,14478,1657681,11070,2836050,25548,81,6,7,27813,True
92,92.0,92.0,92.0,92.0,92.0,92.0,92.0,92.0,92.0,,,93,1520,9,5864271,249127,75312,502,5939583,249629,3,278333,1255655,15189,1661130,11065,2916785,26254,86,6,7,29442,True
93,93.0,93.0,93.0,93.0,93.0,93.0,93.0,93.0,93.0,,,94,512,9,3613173,66221,75966,501,3689139,66722,2,73975,827311,10497,1658217,11063,2485528,21560,70,6,7,18354,True
94,94.0,94.0,94.0,94.0,94.0,94.0,94.0,94.0,94.0,,,95,512,9,2981098,67318,76838,501,3057936,67819,2,75479,929814,10878,1665637,11069,2595451,21947,72,6,7,19308,True
95,95.0,95.0,95.0,95.0,95.0,95.0,95.0,95.0,95.0,,,96,512,9,2481911,63166,75507,501,2557418,63667,2,70573,716413,8717,1658531,11061,2374944,19778,68,6,7,15918,True
96,96.0,96.0,96.0,96.0,96.0,96.0,96.0,96.0,96.0,,,97,3000,9,14250727,507152,75287,501,14326014,507653,2,573257,1314379,16039,1660827,11065,2975206,27104,85,6,7,29788,True
97,97.0,97.0,97.0,97.0,97.0,97.0,97.0,97.0,97.0,,,98,3000,9,15996009,483194,76878,501,16072887,483695,2,545419,1417564,16927,1666289,11076,3083853,28003,87,6,7,34226,True
98,98.0,98.0,98.0,98.0,98.0,98.0,98.0,98.0,98.0,,,99,3000,9,16752221,492544,75522,501,16827743,493045,2,557119,1233806,14642,1664293,11065,2898099,25707,85,6,7,28813,True
99,99.0,99.0,99.0,99.0,99.0,99.0,99.0,99.0,99.0,,,100,144,9,987432,17276,74104,501,1061536,17777,2,19216,46745,824,1659504,11051,1706249,11875,58,6,7,1601,True
100,100.0,100.0,100.0,100.0,100.0,100.0,100.0,100.0,100.0,,,101,144,9,1207059,18789,75242,501,1282301,19290,2,20899,197427,2812,1665118,11060,1862545,13872,59,6,7,4839,True
101,101.0,101.0,101.0,101.0,101.0,101.0,101.0,101.0,101.0,,,102,144,9,1060288,17810,74969,501,1135257,18311,2,19810,155545,1909,1657049,11058,1812594,12967,60,6,7,3320,True
102,102.0,102.0,102.0,102.0,102.0,102.0,102.0,102.0,102.0,,,103,486,9,4881003,94273,75062,502,4956065,94775,3,105179,997196,12089,1662412,11068,2659608,23157,73,6,7,20762,True
103,103.0,103.0,103.0,103.0,103.0,103.0,103.0,103.0,103.0,,,104,486,9,1814249,67895,75356,501,1889605,68396,2,75749,1367724,15734,1666313,11074,3034037,26808,79,6,7,26708,True
104,104.0,104.0,104.0,104.0,104.0,104.0,104.0,104.0,104.0,,,105,486,9,2579047,72009,74899,501,2653946,72510,2,80339,1267775,15115,1656928,11063,2924703,26178,81,6,7,27311,True
105,105.0,105.0,105.0,105.0,105.0,105.0,105.0,105.0,105.0,,,106,2250,9,12502486,386939,74871,501,12577357,387440,2,438311,1645465,19261,1671407,11073,3316872,30334,75,6,7,33530,True
106,106.0,106.0,106.0,106.0,106.0,106.0,106.0,106.0,106.0,,,107,2250,9,13628313,433470,75559,505,13703872,433975,4,490664,1778171,20008,1658632,11074,3436803,31082,80,6,7,37974,True
107,107.0,107.0,107.0,107.0,107.0,107.0,107.0,107.0,107.0,,,108,2250,9,16618076,413931,75704,506,16693780,414437,3,470441,1154213,14065,1662997,11066,2817210,25131,74,6,7,26156,True
108,108.0,108.0,108.0,108.0,108.0,108.0,108.0,108.0,108.0,,,109,1188,9,6562183,211282,77333,507,6639516,211789,4,236051,1723651,19497,1662173,11066,3385824,30563,86,6,7,36176,True
109,109.0,109.0,109.0,109.0,109.0,109.0,109.0,109.0,109.0,,,110,1188,9,4322441,198377,75136,506,4397577,198883,3,221633,1398322,17309,1660724,11063,3059046,28372,85,6,7,30933,True
110,110.0,110.0,110.0,110.0,110.0,110.0,110.0,110.0,110.0,,,111,1188,9,9199286,224767,75614,505,9274900,225272,4,251117,1535222,18522,1665162,11075,3200384,29597,88,6,7,34485,True
111,111.0,111.0,111.0,111.0,111.0,111.0,111.0,111.0,111.0,,,112,648,9,3478387,93124,75651,502,3554038,93626,3,104127,991783,13289,1664685,11103,2656468,24392,74,6,7,22129,True
112,112.0,112.0,112.0,112.0,112.0,112.0,112.0,112.0,112.0,,,113,648,9,3502291,95241,76493,505,3578784,95746,3,106431,1007578,12506,1665856,11076,2673434,23582,72,6,7,20629,True
113,113.0,113.0,113.0,113.0,113.0,113.0,113.0,113.0,113.0,,,114,648,9,2788432,86742,75257,502,2863689,87244,3,96927,1163806,14234,1664032,11087,2827838,25321,74,6,7,23720,True
114,114.0,114.0,114.0,114.0,114.0,114.0,114.0,114.0,114.0,,,115,1152,9,7039949,169612,75057,501,7115006,170113,2,189736,1522937,17792,1663114,11084,3186051,28876,89,6,7,35052,True
115,115.0,115.0,115.0,115.0,115.0,115.0,115.0,115.0,115.0,,,116,1152,9,4514992,167554,73655,501,4588647,168055,2,187441,1100168,14036,1664907,11075,2765075,25111,91,6,7,30281,True
116,116.0,116.0,116.0,116.0,116.0,116.0,116.0,116.0,116.0,,,117,1152,9,4208032,166321,74095,501,4282127,166822,2,186064,1318394,16671,1655359,11071,2973753,27742,87,6,7,31423,True
117,117.0,117.0,117.0,117.0,117.0,117.0,117.0,117.0,117.0,,,118,2200,9,26285413,382912,75738,504,26361151,383416,3,433459,1031190,13267,1664409,11069,2695599,24336,82,6,7,27115,True
118,118.0,118.0,118.0,118.0,118.0,118.0,118.0,118.0,118.0,,,119,2200,9,22697699,361753,75020,501,22772719,362254,2,405379,989753,12758,1661085,11069,2650838,23827,84,6,7,27166,True
119,119.0,119.0,119.0,119.0,119.0,119.0,119.0,119.0,119.0,,,120,2200,9,16545186,356608,74489,501,16619675,357109,2,403939,1052548,13774,1665720,11079,2718268,24853,80,6,7,27372,True
120,120.0,120.0,120.0,120.0,120.0,120.0,120.0,120.0,,,,121,3600,11,22783909,758662,75549,502,22859458,759164,3,834919,1853707,22465,2194204,14588,4047911,37053,113,7,8,41161,True
121,121.0,121.0,121.0,121.0,121.0,121.0,121.0,121.0,,,,122,3600,11,23565631,730198,73554,501,23639185,730699,2,803899,1831963,21822,2189035,14593,4020998,36415,110,7,8,40932,True
122,122.0,122.0,122.0,122.0,122.0,122.0,122.0,122.0,,,,123,3600,11,22103148,734170,75394,501,22178542,734671,2,807419,1372284,18409,2189967,14590,3562251,32999,107,7,8,34140,True
123,123.0,123.0,123.0,123.0,123.0,123.0,123.0,123.0,,,,124,24000,11,53685349,2047068,75603,504,53760952,2047572,4,2268167,2044061,25115,2192250,14610,4236311,39725,107,7,8,44621,True
124,124.0,124.0,124.0,124.0,124.0,124.0,124.0,124.0,,,,125,24000,11,36598062,2016774,74754,502,36672816,2017276,3,2231988,1832708,21172,2191647,14588,4024355,35760,97,7,8,35993,True
125,125.0,125.0,125.0,125.0,125.0,125.0,125.0,125.0,,,,126,24000,11,65829866,1984243,75615,501,65905481,1984744,2,2199351,1724682,21858,2192493,14605,3917175,36463,102,7,8,38243,True
126,126.0,126.0,126.0,126.0,126.0,126.0,126.0,126.0,,,,127,1152,11,10951817,211714,76154,501,11027971,212215,2,231522,922190,10730,2189850,14576,3112040,25306,97,7,8,22245,True
127,127.0,127.0,127.0,127.0,127.0,127.0,127.0,127.0,,,,128,1152,11,9787026,206926,74888,501,9861914,207427,2,226286,1318730,15592,2192114,14598,3510844,30190,98,7,8,28304,True
128,128.0,128.0,128.0,128.0,128.0,128.0,128.0,128.0,,,,129,1152,11,11916062,211201,75933,501,11991995,211702,2,230961,1041825,12706,2187388,14582,3229213,27288,97,7,8,24682,True
129,129.0,129.0,129.0,129.0,129.0,129.0,129.0,129.0,,,,130,5280,11,15116423,863578,75347,503,15191770,864081,3,948506,1912019,22906,2195861,14617,4107880,37523,106,7,8,40696,True
130,130.0,130.0,130.0,130.0,130.0,130.0,130.0,130.0,,,,131,5280,11,15955216,851448,75564,502,16030780,851950,3,942962,2041540,25993,2196594,14642,4238134,40635,106,7,8,44866,True
131,131.0,131.0,131.0,131.0,131.0,131.0,131.0,131.0,,,,132,5280,11,14829801,853270,75739,502,14905540,853772,3,938573,2290079,26018,2199301,14624,4489380,40642,105,7,8,45503,True
132,132.0,132.0,132.0,132.0,132.0,132.0,132.0,132.0,,,,133,3744,11,13068390,247056,76001,502,13144391,247558,3,271079,939611,11981,2191228,14580,3130839,26561,110,7,8,27566,True
133,133.0,133.0,133.0,133.0,133.0,133.0,133.0,133.0,,,,134,3744,11,6455764,253137,74663,504,6530427,253641,3,277217,958011,12026,2191346,14580,3149357,26606,108,7,8,27385,True
134,134.0,134.0,134.0,134.0,134.0,134.0,134.0,134.0,,,,135,3744,11,8213480,225523,76234,501,8289714,226024,2,247121,1185515,14451,2191985,14581,3377500,29032,108,7,8,29754,True
135,135.0,135.0,135.0,135.0,135.0,135.0,135.0,,,,,136,4320,11,38424996,943316,74311,503,38499307,943819,3,1041137,1807608,21069,2195532,14584,4003140,35653,106,7,8,39217,True
136,136.0,136.0,136.0,136.0,136.0,136.0,136.0,,,,,137,4320,11,36697144,976309,75759,507,36772903,976816,3,1080309,1227807,15435,2186359,14572,3414166,30007,103,7,8,31523,True
137,137.0,137.0,137.0,137.0,137.0,137.0,137.0,,,,,138,4320,11,36676031,1026565,74731,502,36750762,1027067,3,1137004,1444155,16552,2185347,14589,3629502,31141,102,7,8,32515,True
138,138.0,138.0,138.0,138.0,138.0,138.0,138.0,,,,,139,1800,11,7960421,270488,75195,502,8035616,270990,3,297017,1038192,11984,2188178,14577,3226370,26561,92,7,8,21258,True
139,139.0,139.0,139.0,139.0,139.0,139.0,139.0,,,,,140,1800,11,7116843,243515,75011,501,7191854,244016,2,267119,781020,10122,2194336,14577,2975356,24699,92,7,8,18567,True
140,140.0,140.0,140.0,140.0,140.0,140.0,140.0,,,,,141,1800,11,7031488,246880,76235,501,7107723,247381,2,270485,976030,12324,2192729,14597,3168759,26921,95,7,8,21714,True
141,141.0,141.0,141.0,141.0,141.0,141.0,141.0,,,,,142,1200,11,4018131,94691,74867,501,4092998,95192,2,103469,686486,7986,2191107,14577,2877593,22563,90,7,8,17111,True
142,142.0,142.0,142.0,142.0,142.0,142.0,142.0,,,,,143,1200,11,1667488,83517,74919,501,1742407,84018,2,91259,229067,2990,2184953,14569,2414020,17559,94,7,8,11444,True
143,143.0,143.0,143.0,143.0,143.0,143.0,143.0,,,,,144,1200,11,4688468,113566,74899,502,4763367,114068,3,124094,508221,6246,2188531,14573,2696752,20819,91,7,8,14418,True
144,144.0,144.0,144.0,144.0,144.0,144.0,144.0,,,,,145,6000,11,74024376,1267033,74444,501,74098820,1267534,2,1398956,1345817,16064,2186777,14577,3532594,30641,102,7,8,30419,True
145,145.0,145.0,145.0,145.0,145.0,145.0,145.0,,,,,146,6000,11,77640436,1313887,77220,517,77717656,1314404,4,1450238,1439215,17756,2193792,14588,3633007,32344,103,7,8,33367,True
146,146.0,146.0,146.0,146.0,146.0,146.0,146.0,,,,,147,6000,11,56617703,1261349,75196,501,56692899,1261850,2,1391333,1232613,15003,2182290,14575,3414903,29578,97,7,8,27460,True
147,147.0,147.0,147.0,147.0,147.0,147.0,147.0,,,,,148,10400,11,17626157,681129,74937,501,17701094,681630,2,750308,1359950,16046,2190037,14581,3549987,30627,102,7,8,32364,True
148,148.0,148.0,148.0,148.0,148.0,148.0,148.0,,,,,149,10400,11,31362375,692924,74519,501,31436894,693425,2,759779,1123536,14188,2192760,14574,3316296,28762,99,7,8,29329,True
149,149.0,149.0,149.0,149.0,149.0,149.0,149.0,,,,,150,10400,11,19739619,685582,75934,501,19815553,686083,2,753542,1394565,16817,2193465,14583,3588030,31400,100,7,8,33719,True
150,150.0,150.0,150.0,150.0,150.0,150.0,,,,,,151,6500,12,27628874,1275132,74667,502,27703541,1275634,3,1392885,1566467,20447,2793514,18609,4359981,39056,134,8,9,41424,True
151,151.0,151.0,151.0,151.0,151.0,151.0,,,,,,152,6500,12,26355963,1265592,75878,502,26431841,1266094,3,1386549,1589037,19806,2792301,18604,4381338,38410,133,8,9,40331,True
152,152.0,152.0,152.0,152.0,152.0,152.0,,,,,,153,6500,12,24147090,1308311,74909,502,24221999,1308813,3,1431358,1882795,22858,2780959,18594,4663754,41452,135,8,9,46068,True
153,153.0,153.0,153.0,153.0,153.0,153.0,,,,,,154,9120,12,28608085,1324423,84551,560,28692636,1324983,5,1445685,1615535,19368,2794607,18610,4410142,37978,120,8,9,35951,True
154,154.0,154.0,154.0,154.0,154.0,154.0,,,,,,155,9120,12,28142955,1286919,78546,526,28221501,1287445,4,1406877,2383517,28668,2804800,18672,5188317,47340,133,8,9,51723,True
155,155.0,155.0,155.0,155.0,155.0,155.0,,,,,,156,9120,12,33206205,1303758,78902,525,33285107,1304283,5,1423773,1813667,21531,2791620,18617,4605287,40148,123,8,9,40342,True
156,156.0,156.0,156.0,156.0,156.0,156.0,,,,,,157,1152,12,6104130,204096,76536,503,6180666,204599,3,221391,600546,8034,2799487,18638,3400033,26672,111,8,9,17363,True
157,157.0,157.0,157.0,157.0,157.0,157.0,,,,,,158,1152,12,3592119,175245,74245,501,3666364,175746,2,190095,601633,8106,2802415,18658,3404048,26764,112,8,9,16440,True
158,158.0,158.0,158.0,158.0,158.0,158.0,,,,,,159,1152,12,4728447,182148,74497,501,4802944,182649,2,197583,873524,11272,2790682,18640,3664206,29912,120,8,9,23314,True
159,159.0,159.0,159.0,159.0,159.0,,,,,,,160,3456,12,17456201,380326,74489,501,17530690,380827,2,413838,1658023,20080,2788153,18591,4446176,38671,123,8,9,36718,True
160,160.0,160.0,160.0,160.0,160.0,,,,,,,161,3456,12,14681000,379068,75829,501,14756829,379569,2,411558,681568,9101,2787294,18581,3468862,27682,112,8,9,18720,True
161,161.0,161.0,161.0,161.0,161.0,,,,,,,162,3456,12,22275547,383058,75915,501,22351462,383559,2,415890,732949,9490,2788761,18588,3521710,28078,112,8,9,19771,True
162,162.0,162.0,162.0,162.0,162.0,,,,,,,163,9720,12,23765511,1315411,76430,503,23841941,1315914,4,1433541,1843308,23366,2800379,18617,4643687,41983,126,8,9,41979,True
163,163.0,163.0,163.0,163.0,163.0,,,,,,,164,9720,12,24899471,1285481,75945,502,24975416,1285983,3,1401597,1772720,21615,2790709,18602,4563429,40217,122,8,9,36814,True
164,164.0,164.0,164.0,164.0,164.0,,,,,,,165,9720,12,16218471,1264392,74370,502,16292841,1264894,3,1378629,1607979,20496,2786563,18634,4394542,39130,120,8,9,37675,True
165,165.0,165.0,165.0,165.0,165.0,,,,,,,166,24192,12,91324852,5079580,74789,504,91399641,5080084,4,5544924,2485497,31102,2795968,18618,5281465,49720,142,8,9,58777,True
166,166.0,166.0,166.0,166.0,166.0,,,,,,,167,24192,12,95059509,5108262,74822,506,95134331,5108768,5,5571624,2286790,27713,2789784,18595,5076574,46308,137,8,9,53277,True
167,167.0,167.0,167.0,167.0,167.0,,,,,,,168,24192,12,78278033,5064936,75960,504,78353993,5065440,4,5524224,2041308,24593,2796678,18601,4837986,43194,140,8,9,49486,True
168,168.0,168.0,168.0,168.0,168.0,,,,,,,169,4800,12,19706309,593795,75188,502,19781497,594297,3,647877,1234605,15361,2795034,18585,4029639,33946,113,8,9,28533,True
169,169.0,169.0,169.0,169.0,169.0,,,,,,,170,4800,12,13556762,577525,75315,502,13632077,578027,3,630453,1528447,19270,2792831,18593,4321278,37863,120,8,9,35401,True
170,170.0,170.0,170.0,170.0,170.0,,,,,,,171,4800,12,15519748,556177,76223,501,15595971,556678,2,608541,2051281,23347,2790975,18586,4842256,41933,115,8,9,40395,True
171,171.0,171.0,171.0,171.0,,,,,,,,172,8736,12,17353493,525336,75375,501,17428868,525837,2,570499,1609468,19307,2790067,18580,4399535,37887,122,8,9,35409,True
172,172.0,172.0,172.0,172.0,,,,,,,,173,8736,12,12474081,531966,74679,501,12548760,532467,2,577699,1118641,14487,2790992,18581,3909633,33068,115,8,9,26512,True
173,173.0,173.0,173.0,173.0,,,,,,,,174,8736,12,13240851,525778,74780,501,13315631,526279,2,570979,1562717,19168,2787506,18587,4350223,37755,122,8,9,36317,True
174,174.0,174.0,174.0,174.0,,,,,,,,175,480,12,2766304,82163,75660,501,2841964,82664,2,89053,496574,5609,2788841,18572,3285415,24181,102,8,9,10731,True
175,175.0,175.0,175.0,175.0,,,,,,,,176,480,12,2204964,79063,75876,501,2280840,79564,2,85693,283196,3520,2784646,18569,3067842,22089,100,8,9,8377,True
176,176.0,176.0,176.0,176.0,,,,,,,,177,480,12,1784782,77358,74484,501,1859266,77859,2,83845,142145,2002,2792197,18577,2934342,20579,100,8,9,6348,True
177,177.0,177.0,177.0,177.0,,,,,,,,178,5760,12,53517339,1046006,75783,502,53593122,1046508,3,1139779,1070396,13531,2780806,18580,3851202,32111,122,8,9,27404,True
178,178.0,178.0,178.0,178.0,,,,,,,,179,5760,12,63406127,1064088,75762,506,63481889,1064594,3,1156819,1464083,18040,2797555,18591,4261638,36631,126,8,9,35232,True
179,179.0,179.0,179.0,179.0,,,,,,,,180,5760,12,64130377,1030276,74689,501,64205066,1030777,2,1120099,1567520,18477,2788499,18588,4356019,37065,121,8,9,33130,True
180,180.0,180.0,180.0,,,,,,,,,181,11520,14,63817850,2285220,76945,506,63894795,2285726,4,2454473,1789344,22060,3465880,23111,5255224,45171,156,9,10,42652,True
181,181.0,181.0,181.0,,,,,,,,,182,11520,14,81067148,2263396,77702,521,81144850,2263917,3,2431065,1218850,16139,3469157,23123,4688007,39262,152,9,10,33579,True
182,182.0,182.0,182.0,,,,,,,,,183,11520,14,97001826,2259382,74228,502,97076054,2259884,3,2428293,818091,10419,3451282,23077,4269373,33496,153,9,10,29463,True
183,183.0,183.0,183.0,,,,,,,,,184,8320,14,32575143,1933305,74318,502,32649461,1933807,3,2086904,1854344,23428,3470452,23135,5324796,46563,146,9,10,39560,True
184,184.0,184.0,184.0,,,,,,,,,185,8320,14,34582879,1939274,74511,502,34657390,1939776,3,2093022,2159362,27847,3463727,23128,5623089,50975,149,9,10,47957,True
185,185.0,185.0,185.0,,,,,,,,,186,8320,14,32395271,1940692,74572,502,32469843,1941194,3,2096242,2535503,31710,3483710,23123,6019213,54833,156,9,10,54614,True
186,186.0,186.0,186.0,,,,,,,,,187,12800,14,72404346,3223349,74401,501,72478747,3223850,2,3469949,1285963,17005,3459423,23105,4745386,40110,148,9,10,33244,True
187,187.0,187.0,187.0,,,,,,,,,188,12800,14,51032398,3374481,74680,501,51107078,3374982,2,3631860,1898854,23390,3469195,23107,5368049,46497,167,9,10,48487,True
188,188.0,188.0,188.0,,,,,,,,,189,12800,14,72143863,3420023,75932,502,72219795,3420525,3,3673076,1815140,21887,3472545,23115,5287685,45002,153,9,10,40609,True
189,189.0,189.0,189.0,,,,,,,,,190,28800,14,130273493,6343846,74474,503,130347967,6344349,4,6848124,1436628,18209,3471498,23105,4908126,41314,166,9,10,44528,True
190,190.0,190.0,190.0,,,,,,,,,191,28800,14,127150767,6278084,75498,502,127226265,6278586,3,6776724,1688765,21451,3469247,23110,5158012,44561,157,9,10,44882,True
191,191.0,191.0,191.0,,,,,,,,,192,28800,14,125196522,6269478,75063,501,125271585,6269979,2,6739274,1874847,22092,3464701,23114,5339548,45206,162,9,10,50173,True
192,192.0,192.0,192.0,,,,,,,,,193,23040,14,425830775,4962215,76063,501,425906838,4962716,2,5341049,1856330,22563,3464547,23101,5320877,45664,160,9,10,45398,True
193,193.0,193.0,193.0,,,,,,,,,194,23040,14,364443544,4992073,75627,502,364519171,4992575,3,5377393,1195208,15960,3472264,23104,4667472,39064,153,9,10,33741,True
194,194.0,194.0,194.0,,,,,,,,,195,23040,14,334572809,4963393,75214,501,334648023,4963894,2,5342589,2100173,25115,3464641,23100,5564814,48215,167,9,10,51214,True
195,195.0,195.0,195.0,,,,,,,,,196,12000,14,57355695,2207142,75569,506,57431264,2207648,3,2381856,1096695,13845,3457782,23092,4554477,36937,144,9,10,27443,True
196,196.0,196.0,196.0,,,,,,,,,197,12000,14,188734771,2218830,75583,502,188810354,2219332,3,2391194,1046553,13719,3457033,23088,4503586,36807,140,9,10,26968,True
197,197.0,197.0,197.0,,,,,,,,,198,12000,14,152211421,2205936,76240,503,152287661,2206439,3,2377670,1281193,15522,3468312,23110,4749505,38632,136,9,10,28063,True
198,198.0,198.0,198.0,,,,,,,,,199,17280,14,160621218,3645714,74589,502,160695807,3646216,3,3924839,1908181,23751,3470098,23113,5378279,46864,144,9,10,40631,True
199,199.0,199.0,199.0,,,,,,,,,200,17280,14,145722251,3655098,76884,513,145799135,3655611,3,3940967,2005764,24483,3460845,23097,5466609,47580,148,9,10,43387,True
200,200.0,200.0,200.0,,,,,,,,,201,17280,14,163196199,3659054,75302,503,163271501,3659557,3,3937943,2047660,24483,3466731,23103,5514391,47586,146,9,10,42779,True
201,201.0,201.0,201.0,,,,,,,,,202,10080,14,141820977,3063290,75109,504,141896086,3063794,3,3299556,1270120,15837,3475110,23105,4745230,38942,151,9,10,32564,True
202,202.0,202.0,202.0,,,,,,,,,203,10080,14,186284818,3084322,74846,505,186359664,3084827,3,3310504,1358556,16333,3466223,23109,4824779,39442,144,9,10,32514,True
203,203.0,203.0,203.0,,,,,,,,,204,10080,14,176245936,3045922,74771,501,176320707,3046423,2,3269288,1147273,14738,3463720,23088,4610993,37826,140,9,10,26853,True
204,204.0,204.0,204.0,,,,,,,,,205,25600,14,162682019,6298503,75939,507,162757958,6299010,3,6790724,1998925,24790,3470026,23117,5468951,47907,154,9,10,47546,True
205,205.0,205.0,205.0,,,,,,,,,206,25600,14,165761052,6276677,74868,502,165835920,6277179,3,6783724,1621785,20685,3464709,23094,5086494,43779,151,9,10,37977,True
206,206.0,206.0,206.0,,,,,,,,,207,25600,14,184432073,6293393,75959,502,184508032,6293895,3,6801924,1107859,14036,3462709,23098,4570568,37134,142,9,10,29306,True
207,207.0,207.0,207.0,,,,,,,,,208,19600,14,77316844,4283002,76191,509,77393035,4283511,5,4614424,2969239,35805,3481821,23216,6451060,59021,170,9,10,64960,True
208,208.0,208.0,208.0,,,,,,,,,209,19600,14,72178064,4225757,77455,520,72255519,4226277,4,4557724,2677371,32616,3484229,23192,6161600,55808,168,9,10,60311,True
209,209.0,209.0,209.0,,,,,,,,,210,19600,14,61307804,4224620,75989,507,61383793,4225127,4,4547574,2163350,26645,3482292,23201,5645642,49846,159,9,10,50255,True
210,210.0,210.0,,,,,,,,,,211,14280,14,28294057,1031101,74170,501,28368227,1031602,2,1109437,1002205,12748,3465257,23095,4467462,35843,133,9,10,22172,True
211,211.0,211.0,,,,,,,,,,212,14280,14,30125631,1035892,75169,501,30200800,1036393,2,1115905,1460985,18005,3474229,23111,4935214,41116,140,9,10,30665,True
212,212.0,212.0,,,,,,,,,,213,14280,14,33020053,1069727,75122,502,33095175,1070229,3,1151017,1232298,14432,3471794,23100,4704092,37532,133,9,10,24835,True
213,213.0,213.0,,,,,,,,,,214,14400,12,50452979,2050848,75703,504,50528682,2051352,3,2229968,1724613,21591,2795126,18603,4519739,40194,123,8,9,36507,True
214,214.0,214.0,,,,,,,,,,215,14400,12,71873477,2016496,75708,501,71949185,2016997,2,2192672,1628109,20252,2798586,18617,4426695,38869,128,8,9,35447,True
215,215.0,215.0,,,,,,,,,,216,14400,12,40589264,2025569,76425,502,40665689,2026071,3,2208548,1800771,22204,2788523,18632,4589294,40836,133,8,9,42265,True
216,216.0,216.0,,,,,,,,,,217,17280,14,58860228,3181408,75340,502,58935568,3181910,3,3430932,2196359,27009,3467258,23123,5663617,50132,160,9,10,49055,True
217,217.0,217.0,,,,,,,,,,218,17280,14,58328957,3179962,77218,504,58406175,3180466,3,3426424,1775383,23299,3464769,23107,5240152,46406,163,9,10,44724,True
218,218.0,218.0,,,,,,,,,,219,17280,14,57291798,3178378,75216,502,57367014,3178880,3,3425780,2046288,25397,3477911,23115,5524199,48512,161,9,10,46934,True
219,219.0,219.0,,,,,,,,,,220,16128,14,81599921,2221230,75203,501,81675124,2221731,2,2391122,1322295,16623,3473503,23105,4795798,39728,140,9,10,29992,True
220,220.0,220.0,,,,,,,,,,221,16128,14,89871410,2329287,75119,501,89946529,2329788,2,2507757,1932654,23697,3466465,23107,5399119,46804,156,9,10,43045,True
221,221.0,221.0,,,,,,,,,,222,16128,14,54948575,2356481,76094,502,55024669,2356983,3,2533321,1674824,20563,3466652,23121,5141476,43684,147,9,10,36020,True
222,222.0,222.0,,,,,,,,,,223,15000,11,131047013,3904888,75000,504,131122013,3905392,3,4318625,2030205,23264,2188278,14585,4218483,37849,113,7,8,45033,True
223,223.0,223.0,,,,,,,,,,224,15000,11,130992054,3743261,75179,501,131067233,3743762,2,4127499,1589982,19823,2192796,14587,3782778,34410,116,7,8,41239,True
224,224.0,224.0,,,,,,,,,,225,15000,11,120580990,3765645,75632,502,120656622,3766147,3,4164349,2252959,26794,2188444,14580,4441403,41374,112,7,8,49585,True
225,225.0,,,,,,,,,,,226,17280,12,56405472,3234220,81969,545,56487441,3234765,4,3554424,1750640,20956,2792592,18608,4543232,39564,126,8,9,41315,True
226,226.0,,,,,,,,,,,227,17280,12,73960698,3087892,77719,511,74038417,3088403,3,3387479,2376527,28518,2807982,18655,5184509,47173,134,8,9,53129,True
227,227.0,,,,,,,,,,,228,17280,12,90926456,3253718,75704,509,91002160,3254227,4,3567024,1803328,22591,2793921,18593,4597249,41184,132,8,9,44145,True
228,228.0,,,,,,,,,,,229,18000,11,145955226,4565965,74117,502,146029343,4566467,3,5002549,1644119,20420,2191929,14579,3836048,34999,109,7,8,39078,True
229,229.0,,,,,,,,,,,230,18000,11,126420658,4540382,76690,502,126497348,4540884,3,4998149,1895224,22750,2194381,14583,4089605,37333,109,7,8,42462,True
230,230.0,,,,,,,,,,,231,18000,11,126065437,4375198,75751,502,126141188,4375700,3,4812479,1697851,21651,2192911,14590,3890762,36241,110,7,8,40627,True
231,231.0,,,,,,,,,,,232,17100,12,77305700,3361499,75792,504,77381492,3362003,3,3673751,1812588,23111,2790037,18596,4602625,41707,137,8,9,47978,True
232,232.0,,,,,,,,,,,233,17100,12,84162935,3372265,74927,502,84237862,3372767,3,3684119,1944340,23354,2788393,18603,4732733,41957,131,8,9,45707,True
233,233.0,,,,,,,,,,,234,17100,12,99401282,3365333,76317,503,99477599,3365836,3,3684983,1915867,22925,2792637,18598,4708504,41523,132,8,9,46760,True
234,234.0,,,,,,,,,,,235,17920,12,105570335,3349208,76036,502,105646371,3349710,3,3671641,2187093,27319,2797891,18630,4984984,45949,128,8,9,48338,True
235,235.0,,,,,,,,,,,236,17920,12,90228669,3181410,75935,505,90304604,3181915,3,3497724,1824062,24442,2793401,18654,4617463,43096,128,8,9,43921,True
236,236.0,,,,,,,,,,,237,17920,12,99284941,3392268,80699,533,99365640,3392801,4,3709081,1779233,22204,2794062,18604,4573295,40808,125,8,9,42744,True
237,237.0,,,,,,,,,,,238,20250,12,127297915,3686210,75173,502,127373088,3686712,3,4023274,1871373,24262,2787512,18606,4658885,42868,135,8,9,47030,True
238,238.0,,,,,,,,,,,239,20250,12,115037018,3822017,75325,502,115112343,3822519,3,4191575,1779581,22524,2779982,18596,4559563,41120,133,8,9,44363,True
239,239.0,,,,,,,,,,,240,20250,12,124290622,3835028,74455,502,124365077,3835530,3,4195031,2138585,25893,2784689,18598,4923274,44491,136,8,9,49818,True
240,,,,,,,,,,,,241,30000,11,101852770,3058657,74201,503,101926971,3059160,4,3374549,2468581,29860,2188166,14607,4656747,44467,119,7,8,56837,True
241,,,,,,,,,,,,242,30000,11,86316937,2916426,75078,503,86392015,2916929,3,3217127,2290766,28622,2193778,14611,4484544,43233,118,7,8,55439,True
242,,,,,,,,,,,,243,30000,11,88098934,2930658,75904,502,88174838,2931160,3,3229007,2050850,24812,2190756,14599,4241606,39411,112,7,8,48141,True
243,,,,,,,,,,,,244,28000,12,177052489,4928534,74306,502,177126795,4929036,3,5437524,1815781,22645,2790956,18602,4606737,41247,121,8,9,38363,True
244,,,,,,,,,,,,245,28000,12,167747411,4982430,74834,503,167822245,4982933,4,5476824,1597504,20467,2790750,18599,4388254,39066,117,8,9,34599,True
245,,,,,,,,,,,,246,28000,12,179593067,4939280,74967,502,179668034,4939782,3,5447124,1618748,19818,2796893,18598,4415641,38416,118,8,9,33402,True
246,,,,,,,,,,,,247,29376,14,329915147,5011631,76097,507,329991244,5012138,3,5384506,1853708,22677,3474069,23115,5327777,45792,150,9,10,39167,True
247,,,,,,,,,,,,248,29376,14,296875491,4989818,75452,503,296950943,4990321,3,5369372,1902088,24741,3469160,23110,5371248,47851,151,9,10,42865,True
248,,,,,,,,,,,,249,29376,14,404929581,5030781,75147,502,405004728,5031283,3,5405114,1510602,19455,3473294,23112,4983896,42567,147,9,10,33366,True
249,,,,,,,,,,,,250,28800,12,109060866,3854096,75761,502,109136627,3854598,3,4212023,1677550,21261,2789488,18596,4467038,39857,122,8,9,38427,True
250,,,,,,,,,,,,251,28800,12,102547008,3840685,75101,502,102622109,3841187,3,4188983,1926615,23411,2802025,18614,4728640,42025,125,8,9,42578,True
251,,,,,,,,,,,,252,28800,12,124652159,3845876,75345,502,124727504,3846378,3,4195607,1666361,21336,2794220,18597,4460581,39933,124,8,9,38109,True
252,,,,,,,,,,,,253,28800,12,48085866,1438170,75777,503,48161643,1438673,3,1565541,1715227,20129,2789554,18589,4504781,38718,136,8,9,44663,True
253,,,,,,,,,,,,254,28800,12,64290771,1517802,75797,502,64366568,1518304,3,1653814,1734277,23224,2790603,18604,4524880,41828,142,8,9,48413,True
254,,,,,,,,,,,,255,28800,12,68485763,1411747,74930,501,68560693,1412248,2,1541781,1377501,17146,2791321,18586,4168822,35732,136,8,9,40097,True
